0 0 1 2 3 2 3 2 3 2 3 2 3 2 3 2 4 5 6 6 7 8 6 6 7 8 6 6 7 8 6 6 7 8 6 6 7 8 6 6 4 5 9 5 5 5 10 10 10 10 7 8 11 12 7 8 4 5 7 8 11 12 7 8 13 14 5 5 5 5 15 16 4 5 7 8 11 12 7 8 4 5 7 8 4 5 7 8 4 5 7 8 11 12 10 10,
10 10 17 18 19 20 21 18 19 20 21 18 19 20 21 18 13 14 6 6 22 8 6 6 22 8 6 6 22 8 6 6 22 8 6 6 22 8 6 6 23 9 13 14 24 25 10 10 10 10 7 8 4 5 7 8 26 27 7 8 4 5 7 8 28 29 4 5 5 5 5 5 26 27 7 8 28 29 7 8 4 5 7 8 4 5 22 8 26 27 7 8 30 31 10 10,
10 10 6 6 7 8 6 6 7 8 6 6 7 8 6 6 10 10 10 10 10 10 10 10 10 10 10 10 10 10 10 10 10 10 10 10 10 10 10 10 10 10 10 10 10 10 10 10 10 10 7 8 4 5 7 8 11 12 7 8 4 5 7 8 32 16 4 5 5 5 5 5 33 12 7 8 32 16 7 8 4 5 7 8 4 5 10 6 34 12 7 8 13 14 10 10,
10 10 35 36 7 8 37 36 7 8 37 36 7 8 6 6 4 5 17 18 19 20 21 18 19 20 21 18 19 20 21 18 19 20 21 18 19 20 21 18 7 8 4 5 5 5 28 29 6 31 7 8 38 25 22 8 38 25 22 8 38 25 22 8 4 5 5 5 26 27 38 25 5 5 7 8 30 31 22 8 38 25 22 8 26 27 7 8 39 25 22 8 13 14 10 10,
10 10 35 36 7 8 37 36 7 8 37 36 22 8 10 10 5 5 6 6 7 8 6 6 7 8 6 6 7 8 6 6 7 8 6 6 7 8 6 6 7 8 4 5 5 5 15 16 6 40 7 8 10 10 10 10 10 10 10 10 10 10 10 10 5 5 5 5 33 12 10 10 5 5 7 8 13 14 10 10 10 10 10 10 33 12 7 8 10 10 10 10 10 10 10 10,
10 10 35 36 7 8 37 36 7 8 41 42 10 10 5 5 43 31 6 6 7 8 6 6 7 8 6 6 7 8 6 6 7 8 37 36 7 8 37 36 7 8 4 5 13 14 24 25 6 44 22 8 28 29 45 20 21 18 19 20 21 18 19 46 5 5 5 5 5 5 19 46 43 31 47 48 21 18 19 20 21 18 7 8 13 14 47 48 21 18 19 20 21 49 10 10,
10 10 35 36 7 8 37 36 22 8 42 5 5 5 5 5 13 14 6 6 7 8 6 6 7 8 6 6 7 8 6 6 7 8 37 36 7 8 37 36 7 8 4 5 6 10 10 10 10 10 10 10 32 16 7 8 6 6 7 8 6 6 7 8 4 5 5 5 5 5 7 8 13 14 7 8 6 6 7 8 6 6 7 8 10 10 7 8 6 6 7 8 6 6 10 10,
10 10 35 50 22 8 37 50 6 10 13 14 24 25 24 25 13 14 6 6 22 8 6 6 22 8 6 6 22 8 6 6 7 8 37 36 7 8 37 36 7 8 10 10 10 10 10 10 10 10 47 48 51 52 7 8 4 5 7 8 4 5 22 8 13 14 26 27 38 25 22 8 53 54 22 8 13 14 22 8 38 25 22 8 38 25 22 8 38 25 22 8 38 25 10 10,
10 10 10 10 10 10 10 10 10 10 10 10 10 10 10 10 10 10 10 10 10 10 10 10 10 10 10 10 10 10 10 10 7 8 37 36 7 8 37 36 7 8 10 10 10 10 10 10 10 10 7 8 11 12 22 8 4 5 22 8 4 5 10 10 10 10 33 12 10 10 10 10 55 56 10 10 10 10 10 10 10 10 10 10 10 10 10 10 10 10 10 10 10 10 10 10,
10 10 57 58 57 58 57 58 57 58 57 58 57 58 57 58 57 58 57 58 57 58 57 58 57 58 57 58 57 59 10 10 22 8 37 50 22 8 37 50 22 8 10 10 10 10 10 10 10 10 7 8 23 9 10 10 28 29 10 10 17 18 19 20 21 18 6 6 21 18 19 20 6 6 45 20 21 18 19 20 21 18 19 20 21 18 19 20 21 18 19 20 21 49 10 10,
60 60 61 62 61 62 61 62 61 62 61 62 61 62 61 62 61 62 61 62 61 62 61 62 61 62 61 62 61 62 10 10 10 10 10 10 10 10 10 10 10 10 10 10 10 10 10 10 10 10 22 8 9 5 47 48 15 63 47 48 6 6 64 65 6 6 6 6 6 6 64 65 6 6 64 65 6 6 64 65 6 6 64 65 6 6 64 65 6 6 64 65 6 6 66 67,
68 68 6 6 6 6 6 6 6 6 6 6 6 6 6 6 6 6 6 6 6 6 6 6 6 6 6 6 6 6 6 6 6 6 6 6 6 6 6 6 6 6 6 6 6 6 6 6 6 6 6 6 6 6 6 6 6 6 6 6 6 6 6 6 6 6 6 6 6 6 6 6 6 6 6 6 6 6 6 6 6 6 6 6 6 6 6 6 6 6 6 6 6 6 6 6
