0 0 1 2 3 4 1 2 4 4 1 2 4 4 1 2 4 4 1 2 4 4 4 4 4 4 1 2 5 6 1 2 4 4 1 2 4 4 1 2 4 4 1 2 4 4 1 2 0 4 5 6 7 8 1 2 4 4 7 8 5 6 4 4 1 2 4 4 5 6 1 2 4 4 4 4 5 6 0 0,
0 0 1 9 4 4 1 2 4 4 1 2 10 11 1 2 4 4 1 2 4 4 4 4 12 13 1 2 4 4 1 2 4 4 1 2 4 4 1 2 4 4 1 2 4 4 1 2 14 11 15 16 4 4 1 2 10 11 12 13 4 4 4 4 1 2 12 13 4 4 1 2 10 11 12 13 4 4 0 0,
0 0 0 0 4 4 1 2 4 4 1 2 17 18 1 2 4 4 0 0 4 4 4 4 5 6 1 2 4 4 1 2 4 4 1 2 4 4 1 2 4 4 1 2 4 4 1 2 14 19 7 8 4 4 1 2 17 18 5 6 4 4 4 4 1 2 5 6 4 4 1 2 17 18 5 6 4 4 0 0,
0 0 1 2 20 21 1 2 20 21 1 2 17 18 1 2 20 21 1 2 20 21 17 18 17 18 1 2 20 21 1 2 20 21 1 2 17 18 1 2 17 18 1 2 20 21 1 2 14 22 4 4 12 13 1 2 17 18 4 4 20 21 20 21 1 2 15 16 4 4 1 2 17 18 20 21 4 4 0 0,
0 0 0 0 0 0 0 0 0 0 0 0 0 0 0 0 0 0 1 2 0 0 0 0 0 0 0 0 0 0 0 0 0 0 0 0 0 0 0 0 0 0 0 0 0 0 0 0 0 0 4 4 5 6 0 0 0 0 4 4 0 0 0 0 0 0 7 8 4 4 23 0 0 0 0 0 4 4 0 0,
0 0 1 2 24 25 26 27 24 25 26 27 24 25 26 27 24 25 26 27 24 25 26 27 24 25 26 27 24 25 26 27 24 25 26 27 24 25 26 27 24 25 26 27 24 25 0 0 0 4 4 4 17 18 1 2 0 0 4 4 4 4 0 0 0 4 20 21 10 11 0 0 15 16 10 11 4 4 0 0,
0 0 1 2 28 28 1 2 28 28 1 2 28 28 1 2 28 28 1 2 28 28 1 2 28 28 1 2 28 28 1 2 28 28 1 2 28 28 1 2 28 28 1 2 28 28 0 0 0 4 4 4 0 0 1 2 0 0 4 4 4 4 0 0 0 4 0 0 17 18 0 0 7 8 17 18 29 0 0 0,
0 0 1 2 12 13 1 2 12 13 1 2 12 13 1 2 12 13 1 2 12 13 1 2 12 13 1 2 12 13 1 2 12 13 1 2 12 13 1 2 12 13 1 2 12 13 0 0 0 4 12 13 15 16 1 2 0 0 4 4 12 13 0 0 0 4 4 4 17 18 0 0 4 4 30 3 1 2 0 0,
0 0 1 2 5 6 1 2 5 6 1 2 5 6 1 2 5 6 1 2 5 6 1 2 5 6 1 2 5 6 1 2 5 6 1 2 5 6 1 2 5 6 1 2 5 6 0 0 0 4 5 6 7 8 1 2 0 0 4 4 5 6 0 0 0 4 4 4 0 0 0 0 4 4 3 4 1 2 0 0,
0 0 1 2 15 16 1 2 4 4 1 2 15 16 1 2 15 16 1 2 10 11 1 2 4 4 1 2 15 16 1 2 4 4 1 2 15 16 1 2 4 4 1 2 15 16 0 0 0 4 10 11 4 4 1 2 0 0 4 4 4 4 0 0 0 4 4 4 4 4 4 4 30 3 4 4 1 2 0 0,
0 0 1 2 7 8 1 2 4 4 1 2 7 8 1 2 7 8 1 2 17 18 1 2 4 4 1 2 7 8 1 2 4 4 1 2 7 8 1 2 4 4 1 2 7 8 0 0 0 4 17 18 4 4 1 2 0 0 4 4 4 4 0 0 0 4 4 4 4 4 4 4 3 4 4 4 1 2 0 0,
31 31 31 31 31 31 31 31 31 31 31 31 31 31 31 31 31 31 31 31 31 31 31 31 31 31 31 31 31 31 31 31 31 31 31 31 31 31 31 31 31 31 31 31 31 31 31 31 31 31 31 31 31 31 31 31 31 31 31 31 31 31 31 31 31 31 31 31 31 31 31 31 31 31 31 31 31 31 31 31
