0 0 1 1 1 1 2 3 1 1 1 1 4 5 6 7 6 7 6 7 6 7 6 7 6 7 6 7 6 7 6 7 6 7 6 7 6 7 6 7 6 7 6 7 6 7 0 0,
0 0 1 1 1 1 8 8 1 1 1 1 4 5 9 10 9 10 11 12 13 14 11 12 15 16 11 12 15 16 11 12 15 16 11 12 15 16 11 12 15 16 11 12 17 17 0 0,
0 0 1 1 18 19 8 8 18 19 1 1 4 5 6 7 6 7 1 1 4 5 1 1 4 5 1 1 4 5 1 1 4 5 1 1 4 5 1 1 4 5 1 1 17 17 0 0,
0 0 1 1 20 21 8 8 20 21 1 1 4 5 17 17 17 17 22 23 4 5 22 23 4 5 22 23 4 5 22 23 4 5 22 23 4 5 22 23 4 5 22 23 17 17 0 0,
0 0 18 19 20 21 8 8 20 21 18 19 4 5 17 17 17 17 24 25 4 5 24 25 4 5 24 25 4 5 24 25 4 5 24 25 4 5 24 25 4 5 24 25 17 17 0 0,
26 27 20 21 20 21 1 1 20 21 20 21 4 5 17 17 17 17 28 25 4 5 28 25 4 5 28 25 4 5 28 25 4 5 28 25 4 5 28 25 4 5 28 25 17 17 0 0,
29 30 20 21 20 21 1 1 20 21 20 21 4 5 17 17 17 17 24 25 4 5 24 25 4 5 24 25 4 5 24 25 4 5 24 25 4 5 24 25 4 5 24 25 17 17 0 0,
31 32 33 34 33 34 35 36 33 34 33 34 4 5 0 0 0 0 0 0 0 0 0 0 0 0 0 0 0 0 0 0 0 0 0 0 0 0 0 0 0 0 0 0 17 17 0 0,
0 0 0 0 0 0 0 0 0 0 0 0 0 0 17 17 17 17 17 17 17 17 17 17 17 17 17 17 17 17 17 17 17 17 17 17 17 17 17 17 17 17 17 17 37 0 0 0,
9 10 9 10 9 10 9 10 9 10 9 10 9 10 9 10 9 10 11 12 15 16 11 12 15 16 11 12 15 16 11 12 15 16 11 12 15 16 11 12 15 16 38 39 17 17 0 0,
6 7 6 7 6 7 6 7 6 7 6 7 6 7 6 7 6 7 1 1 4 5 1 1 4 5 1 1 4 5 1 1 4 5 1 1 4 5 1 1 4 5 39 17 17 17 0 0,
40 40 40 40 40 40 40 40 40 40 40 40 40 40 40 40 40 40 40 40 40 40 40 40 40 40 40 40 40 40 40 40 40 40 40 40 40 40 40 40 40 40 40 40 40 40 40 40
