0 1 1 1 1 1 2 2 0 1 1 1 3 4 5 2 2 2 2 2 6 7 8 9,
10 11 10 10 10 10 12 12 10 11 10 10 13 14 15 16 16 16 17 18 19 20 21 22,
11 23 11 11 11 11 11 11 11 23 11 11 24 25 25 25 25 25 26 27 28 29 30 31,
32 33 23 32 32 23 32 23 32 33 23 32 34 27 35 27 27 27 36 37 38 39 40 41,
42 43 44 45 46 47 46 47 45 43 44 45 48 49 50 49 51 52 53 54 55 56 57 58,
37 37 37 37 37 37 37 37 37 37 37 37 37 37 37 37 37 37 37 37 37 37 37 37
