0 0 1 2 1 2 1 2 1 2 1 2 0 0 0 0 0 0 1 2 1 2 1 2 3 4 5 4 0 0 0 0 0 0 0 0 0 0 0 0 6 7 8 9 8 9 10 11,
12 13 14 15 14 15 14 15 14 15 14 15 16 16 16 16 12 13 14 15 14 15 14 15 17 18 19 18 20 16 16 16 16 16 16 16 16 16 16 16 21 22 23 24 25 24 26 27,
28 29 28 29 28 29 28 29 28 29 28 29 30 31 30 31 28 29 28 29 28 29 28 29 32 33 34 33 35 36 37 36 37 36 37 36 37 36 37 36 38 39 40 41 42 41 43 44,
45 46 47 48 45 46 45 46 45 46 45 46 14 15 14 15 45 46 47 48 45 46 45 46 49 50 51 50 52 18 19 18 19 18 19 18 53 54 55 56 57 23 58 59 60 61 62 63,
28 29 64 65 28 29 28 29 28 29 28 29 28 29 28 29 28 29 64 65 28 29 28 29 32 33 34 33 34 33 34 33 34 33 34 33 66 67 68 67 69 70 71 72 40 41 73 11,
47 48 74 69 47 48 47 48 47 48 47 48 47 48 47 48 47 48 74 69 47 48 47 48 75 76 77 76 77 76 77 76 77 76 77 76 78 69 79 69 69 80 81 63 80 61 26 27,
64 65 82 83 64 65 64 65 64 65 64 65 64 65 64 65 64 65 82 83 64 65 64 65 68 67 68 67 68 67 68 67 68 67 68 67 84 85 69 69 69 70 73 11 40 41 43 44,
86 87 88 89 74 69 86 87 86 87 74 69 86 87 74 69 86 87 88 89 74 69 86 87 90 91 79 69 92 91 79 69 79 69 79 69 93 94 69 69 69 70 95 96 70 97 98 27,
99 100 101 102 103 103 99 100 99 104 105 103 99 104 105 103 99 100 101 102 103 103 99 100 106 107 108 109 106 107 108 109 109 109 110 111 112 113 114 115 116 117 118 119 120 121 122 44,
123 124 125 126 127 127 128 124 128 124 127 127 128 124 127 127 128 124 125 126 127 127 128 124 129 130 131 132 133 130 131 132 132 132 134 135 136 137 138 139 140 141 142 143 144 145 146 132,
69 69 69 69 69 69 69 69 69 69 69 69 69 69 69 69 69 69 69 69 69 69 69 69 69 69 69 69 69 69 69 69 69 69 69 69 69 69 69 69 69 69 69 69 69 69 69 69,
69 69 69 69 69 69 69 69 69 69 69 69 69 69 69 69 69 69 69 69 69 69 69 69 69 69 69 69 69 69 69 69 69 69 69 69 69 69 69 69 69 69 69 69 69 69 69 69
