[
  [0, 1, 1, 3, 1, 1, 6, 7, 7, 9, 10, 9, 12, 9, 12, 9, 12, 9, 12, 9, 12, 9, 22, 0],
  [0, 1, 26, 27, 26, 1, 6, 22, 22, 33, 6, 33, 6, 33, 6, 33, 6, 33, 6, 33, 6, 33, 46, 0],
  [48, 26, 50, 51, 50, 26, 6, 46, 46, 57, 6, 57, 6, 57, 6, 57, 6, 57, 6, 57, 6, 57, 46, 0],
  [72, 73, 73, 75, 73, 73, 6, 79, 79, 81, 82, 81, 82, 81, 82, 81, 82, 81, 82, 81, 82, 81, 46, 0],
  [96, 96, 96, 96, 96, 96, 96, 103, 103, 105, 106, 105, 106, 105, 106, 105, 106, 105, 106, 105, 106, 117, 118, 0],
  [120, 120, 120, 120, 120, 120, 120, 120, 120, 129, 130, 129, 130, 129, 130, 129, 130, 129, 130, 129, 130, 141, 142, 143]
]
